.............
SSSSSSSSSSSS.
.............
.............
.............
.............
.............
.............
.............
.............
.............
.............
......E......
